# # # # # # # # # # # # # # # # # # # # 
# X . . . . . . . . #               G # 
# # # # # # # # # . #   # # # # # # # # 
# . . . . . . . . . . . . . . . . . . # 
# . # # # # # # # # # # # # # # # # . # 
# . #                             # . # 
# . #                             # . # 
# . #                             # . # 
# . #                             # . # 
# . #                             # . # 
# . #                             # . # 
# . #                             # . # 
# . #                             # . # 
# . #                             # . # 
# . #                             # . # 
# . #                             # . # 
# . #                             # . # 
# . # # # # # # # # # # # # # # # # . # 
# . . . . . . . . . . . . . . . . . . # 
# # # # # # # # # # # # # # # # # # # # 
