# # # # # # # # # # # # # # # # # # # # 
# . . # # . # . . # # . . # . # # . . # 
# . . # # . . . # # # # . . . # # . . # 
# . # # # . # # # # # # # # . # # # . # 
# . # # # . . # # # # # # . . # # # . # 
# . . . . . . # . # # . # . . . . . . # 
# . # # # . . # . # # . # . . # # # . # 
# . . . . . . . . # # . . . . . . . . # 
# . . . . # # . . . . . . # # . . . . # 
# . # # # # # . . . . . . # # # # # . # 
# . # # # # # . . . X . . # # # # # . # 
# . . . . # # . . . . . . # # . . . . # 
# . . . . . . . . # # . . . . . . . . # 
# . # # # . . # . # # . # . . # # # . # 
# . . . . . . # . # # . # . . . . . . # 
# . # # # . . # # # # # # . . # # # . # 
# . # # # . # # # # # # # # . # # # . # 
# . . # # . . . # # # # . . . # # . . # 
# . . # # . # . . # # . . # . # # . G # 
# # # # # # # # # # # # # # # # # # # # 
