# # # # # # # # # # # # # # # # # # # # 
# . .           . . . . . . .       # # 
#   # #   # # # # # # # # # # # #   # # 
#   # #                               #  
#   # #   # #   # # # # # # # # # # # #  
#   # #   # #   # # # # # # # # # # # # 
#         # #   # # # # # # # # # # # # 
# . # #   # #           .             # 
# . # #   # #   # #   # # #   # # #   # 
# . # #   # # . # #   # # #   # # #   #  
# . # #   # # . #   G   . .   # # #   #  
# # # #   # # # #     # # # # # # #   # 
#                 X # # # # # # # #   # 
#   # # # # # # #   # # # # # # # #   # 
#   # # # # # # # . # # # #           # 
#   # # # # # # # . # # # #   # # #   #  
#   # # # # # # # . # # # # . # # #   #  
#   # # # # # # #   # # # #   # # #   # 
#   . . . . .       # # # #     .     #  
# # # # # # # # # # # # # # # # # # # # 