# # # # # # # # # # # # # # # # # # # # 
#   X                                 # 
#                                     # 
#                                     # 
#                                     # 
#                                     # 
#                                     # 
#                                     # 
#                                     # 
#                 G                   # 
#                                     # 
#                                     # 
#                                     # 
#                                     # 
#             # # # #                 # 
#                                     # 
#                 . . . .             # 
#                                     # 
#                                     # 
# # # # # # # # # # # # # # # # # # # # 
